main:
wb,wb,wb,wb,wb,wb,wb,wb,wb,wb;
wb,--,ps,--,wb,wb,xx,xx,xx,wb;
wb,--,wb,--,wb,--,bx,--,wb,wb;
wb,--,--,--,--,bx,--,--,--,wb;
wb,wb,bx,--,--,wb,--,wb,--,wb;
--,wb,--,--,--,wb,--,--,--,wb;
ex,wb,wb,wb,wb,wb,wb,wb,wb,wb;
ground:
--,--,--,--,--,--,--,--,--,--;
--,sl,sl,sl,--,--,sl,sl,sl,--;
--,sl,--,sl,--,sl,sl,sl,sl,--;
--,sl,sl,sl,sl,sl,sl,sl,sl,--;
--,--,sl,sl,sl,--,sl,--,sl,--;
--,--,sl,sl,sl,--,sl,sl,sl,--;
--,--,--,--,--,--,--,--,--,--;
switchable:
x0y6;x0y6;x0y6;